###########
#...#.#...#
#.#.....#.#
#..#.###..#
##..#...#.#
##.#..#.#.#
#..#.#..#.#
#.#..#.#..#
#.###..#.##
#.....#....
###########
